{
    "1": 200,
    "2": 300,
    "3": 500,
    "4": 600,
    "5": 720,
    "6": 864,
    "7": 1036,
    "8": 1243,
    "9": 1491,
    "10": 1789,
    "11": 2146,
    "12": 2575,
    "13": 3090,
    "14": 3708,
    "15": 4449,
    "16": 5338,
    "17": 5000,
    "18": 5000,
    "19": 5000,
    "20": 5000,
    "21": 5000,
    "22": 5000,
    "23": 5000,
    "24": 5000,
    "25": 5000,
    "26": 5000,
    "27": 5000,
    "28": 5000,
    "29": 5000,
    "30": 5000,
    "31": 5000,
    "32": 5000,
    "33": 5000,
    "34": 5000,
    "35": 5000,
    "36": 5000,
    "37": 5000,
    "38": 5000,
    "39": 5000,
    "40": 5000,
    "41": 5000,
    "42": 5000,
    "43": 5000,
    "44": 5000,
    "45": 5000,
    "46": 5000,
    "47": 5000,
    "48": 5000,
    "49": 5000,
    "50": 5000
}